[1]
m #############
m #.......#...#
m #.......###.#
m #...........#
m #.#######...#
m #.#######...#
m #...........#
m #..###......#
m #...........#
m #############

h 10
w 13