m ############
m #.#........#
m #.#........#
m #.#........#
m #.#........#
m #.#........#
m #.####.#####
m #.#........#
m #.#........#
m #.#........#
m #.#........#
m #..........#
m #.##########
m #.#........#
m #.#........#
m #.#........#
m #.#........#
m #.#........#
m #.####.#####
m #.#.....#..#
m #.#........#
m #.#.....#..#
m #.#.....#..#
m #.#.....#..#
m #.#.....####
m #..........#
m #.#.....#..#
m ############

h 28
w 12